1111111111111111
1P1100000C1E00C1
1001001100110001
10010C11C00001C1
11C0011110C10101
1100000C11110001
1111111111111111