111111111111111111111
1000000000C0000000001
100P00000C1C000000001
1000000CC111CC0000001
1000CCC1111111CCC0001
1CCCC11111111111CCCC1
1000CCC1111111CCC0001
1000000CC111CC0000001
100000000C1C000000001
1000000000C0000000E01
111111111111111111111
