1111111111111
1P0100000C1E1
1101001100101
10010C11C0001
11C0011110C11
1111111111111