111111111111111111
11P001C00100110C11
100111100100011011
10C000101110000011
111010000C00011111
10C011011000000111
1011110011C1110C11
101111101100111001
10001000C110111101
11000C00001E1C0001
111111111111111111
